1111111111111111111111111
10000000000C0000000000001
1000000001000000000000001
10P000000000000000000E001
1111111111111111111111111
