11111111111111111111
1P000000001000000001
10111100001111110001
10000100000000000001
11110111101111101001
1C000100001000010001
10110111001110111001
10000000000000000001
10111110111110111001
100000001000000E0001
1C1111110000111111C1
11111111111111111111
