111111111111111
1P0C0C0C00000E1
111110111111101
10C010011000001
1010100C1010101
100010011000001
101011001110101
1000C0000000001
1C01010101010C1
111111111111111
