111111111111111
1P00000C00000E1
101110111011101
100010001000001
101010101010101
100010001000001
101011101110101
100000000000001
1C01010101010C1
111111111111111
