111111111
1E0C01111
10P000001
100010001
111111111