1111111111111111111111111
100000000C0C0000000000001
1111000001000000000000001
11PC00000100000000000E001
1111111111111111111111111
