1111111111
1000000001
10CCCCCC01
10P0000E01
1111111111
