1111111111
1CCCCCCCC1
1P000000E1
1111111111
